1111111111111111111111111111111111
100000000000000C00000C000000000001
1000111110010001000001000011111001
1000100000010010000011000000001001
1000111100010100000101000000001001
1000100000011000001001000011111001
1000100000010100010001000010000001
10001000E0010010011111100010000001
1000100000010001000001000011111001
1P0000000C00C000000000000000000001
1111111111111111111111111111111111