111111111111
10000P000001
101010000001
100000000C01
100000100001
10000E000001
111111111111